Genero	Filo
Adlercreutzia	Actinobacteria
Abiotrophia	Firmicutes
Actinobaculum	Actinobacteria
Acidaminococcus	Firmicutes
Acinetobacter	Proteobacteria
Acetivibrio	Firmicutes
Afipia	Proteobacteria
Aggregatibacter	Proteobacteria
Agrobacterium	Proteobacteria
Actinomyces	Actinobacteria
Actinobacillus	Proteobacteria
Akkermansia	Verrucomicrobia
Alistipes	Bacteroidetes
Allofustis	Firmicutes
Alloprevotella	Bacteroidetes
Alloscardovia	Firmicutes
Alterileibacterium	Firmicutes
Anaerococcus	Firmicutes
Anaerofustis	Firmicutes
Anaeroglobus	Firmicutes
Anaerosphaera	Proteobacteria
Anaerosporobacter	Bacteroidetes
Anaerostipes	Firmicutes
Anaerotruncus	Firmicutes
Angelakisella	Bacteroidetes
Asaccharospora	Firmicutes
Atopobium	Actinobacteria
Bacteroides	Bacteroidetes
Bariatricus	Firmicutes
Barnesiella	Actinobacteria
Bergeyella	Bacteroidetes
Bifidobacterium	Actinobacteria
Bilophila	Firmicutes
Bittarella	Firmicutes
Blautia	Firmicutes
Bradyrhizobium	Proteobacteria
Brevibacterium	Actinobacteria
Brevundimonas	Proteobacteria
Bulleidia	Firmicutes
Butyricicoccus	Bacteroidetes
Butyricimonas	Bacteroidetes
Butyrivibrio	Firmicutes
Campylobacter	Proteobacteria
Candidatus Stoquefichus	Firmicutes
Capnocytophaga	Bacteroidetes
Cardiobacterium	Proteobacteria
Catabacter	Firmicutes
Catenibacterium	Firmicutes
Catonella	Firmicutes
Centipeda	Proteobacteria
Christensenella	Firmicutes
Chryseobacterium	Bacteroidetes
Citrobacter	Proteobacteria
Cloacibacillus	Synergistetes
Clostridioides	Firmicutes
Clostridium	Firmicutes
Colibacter	Proteobacteria
Collinsella	Actinobacteria
Comamonas	Proteobacteria
Coprobacillus	Firmicutes
Coprobacter	Firmicutes
Coprococcus	Firmicutes
Corynebacterium	Actinobacteria
Criibacterium	Firmicutes
Cryptobacterium	Actinobacteria
Culturomica	
Delftia	Proteobacteria
Desulfovibrio	Proteobacteria
Dialister	Firmicutes
Dielma	Firmicutes
Dietzia	Actinobacteria
Dorea	Firmicutes
Duodenibacillus	Firmicutes
Eggerthella	Actinobacteria
Eggerthia	Firmicutes
Eikenella	Proteobacteria
Eisenbergiella	Firmicutes
Emergencia	Firmicutes
Empedobacter	Bacteroidetes
Ensifer	Proteobacteria
Enterobacter	Proteobacteria
Enterococcus	Firmicutes
Erysipelatoclostridium	Firmicutes
Escherichia	Proteobacteria
Eubacterium	Firmicutes
Ezakiella	Firmicutes
Faecalibacterium	Firmicutes
Faecalibaculum	Firmicutes
Faecalicoccus	Firmicutes
Faecalitalea	Firmicutes
Fenollaria	Firmicutes
Filifactor	Firmicutes
Fournierella	Firmicutes
Fusicatenibacter	Firmicutes
Fusobacterium	Fusobacteria
Gabonia	Firmicutes
Gabonibacter	Bacteroidetes
Gardnerella	Actinobacteria
Gemella	Firmicutes
Gordonia	Actinobacteria
Gordonibacter	Actinobacteria
Granulicatella	Firmicutes
Gulbenkiania	Proteobacteria
Haemophilus	Proteobacteria
Helcococcus	Firmicutes
Helicobacter	Proteobacteria
Hespellia	Firmicutes
Histophilus	Proteobacteria
Holdemanella	Firmicutes
Holdemania	Firmicutes
Hungatella	Firmicutes
Intestinibacter	Proteobacteria
Intestinimonas	Proteobacteria
Johnsonella	Firmicutes
Kallipyga	Firmicutes
Kingella	Proteobacteria
Klebsiella	Proteobacteria
Lachnoanaerobaculum	Firmicutes
Lachnoclostridium	Firmicutes
Lachnospira	Firmicutes
Lactobacillus	Firmicutes
Lactonifactor	Firmicutes
Lagierella	Proteobacteria
Lautropia	Proteobacteria
Lawsonella	Actinobacteria
Leclercia	Proteobacteria
Lelliottia	Proteobacteria
Leptotrichia	Fusobacteria
Levyella	Firmicutes
Libanicoccus	Actinobacteria
Mageeibacillus	Firmicutes
Mannheimia	Proteobacteria
Marvinbryantia	Firmicutes
Massilioclostridium	Firmicutes
Mediterranea	Proteobacteria
Megasphaera	Firmicutes
Merdibacter	Firmicutes
Mitsuokella	Firmicutes
Mobiluncus	Actinobacteria
Mogibacterium	Firmicutes
Morococcus	Proteobacteria
Murdochiella	Actinobacteria
Mycobacterium	Actinobacteria
Mycobacteroides	Actinobacteria
Mycolicibacterium	Actinobacteria
Mycoplasma	Tenericutes
Necropsobacter	Proteobacteria
Negativibacillus	Firmicutes
Neglecta	incierto
Neisseria	Proteobacteria
Neofamilia	incierto
Odoribacter	Bacteroidetes
Olsenella	Actinobacteria
Oribacterium	Firmicutes
Oscillibacter	Firmicutes
Ottowia	Proteobacteria
Parabacteroides	Bacteroidetes
Paracoccus	Proteobacteria
Paraprevotella	Bacteroidetes
Parascardovia	Actinobacteria
Parasutterella	Proteobacteria
Parvimonas	Firmicutes
Pasteurella	Proteobacteria
Pedobacter	Bacteroidetes
Peptoanaerobacter	Firmicutes
Peptoniphilus	Firmicutes
Peptostreptococcus	Firmicutes
Petrimonas	Firmicutes
Phascolarctobacterium	Firmicutes
Phocaeicola	Bacteroidetes
Phocea	Proteobacteria
Polynucleobacter	Proteobacteria
Porphyromonas	Bacteroidetes
Prevotella	Bacteroidetes
Prevotellamassilia	Bacteroidetes
Propionibacterium	Actinobacteria
Pseudoflavonifractor	Firmicutes
Pseudomonas	Proteobacteria
Pseudopropionibacterium	Actinobacteria
Pseudoramibacter	Firmicutes
Psychrobacter	Proteobacteria
Pyramidobacter	Proteobacteria
Raoultella	Proteobacteria
Rikenella	Bacteroidetes
Robinsoniella	Firmicutes
Romboutsia	Firmicutes
Roseburia	Firmicutes
Rothia	Actinobacteria
Ruminococcus	Firmicutes
Ruthenibacterium	Firmicutes
Sanguibacteroides	Bacteroidetes
Scardovia	Actinobacteria
Selenomonas	Firmicutes
Sellimonas	Firmicutes
Senegalimassilia	Actinobacteria
Sharpea	Firmicutes
Shigella	Proteobacteria
Shuttleworthia	Firmicutes
Simonsiella	Proteobacteria
Sinorhizobium	Proteobacteria
Slackia	Actinobacteria
Sneathia	Fusobacteria
Solobacterium	Firmicutes
Staphylococcus	Firmicutes
Stomatobaculum	Firmicutes
Streptobacillus	Fusobacteria
Streptococcus	Firmicutes
Subdoligranulum	Firmicutes
Sutterella	Pseudomonadota
Tannerella	Bacteroidetes
Tepidiphilus	Proteobacteria
Thermosiphon	Thermotogae
Tidjanibacter	Firmicutes
Tissierella	Firmicutes
Traorella	Firmicutes
Treponema	Spirochaetes
Tyzzerella	Firmicutes
Urmitella	Firmicutes
Varibaculum	Actinobacteria
Veillonella	Firmicutes
Xanthomonas	Proteobacteria
